baby	baby#n#1
ball	ball#n#1
bench	bench#n#1
biker	cyclist#n#1
bikers	clclist#n#1
boy	male_child#n#1
boys	male_child#n#1
building	building#n#1
child	child#n#1
children	child#n#1
crowd	crowd#n#1
dirt bikers	cyclist#n#1
dog	dog#n#1
dogs	dog#n#1
girl	female_child#n#1
girls	female_child#n#1
grass	lawn#n#1
group	group#n#1
guy	guy#n#1
hair	hair#n#1
hat	hat#n#1
jacket	jacket#n#1
lady	lady#n#1
little boy	male_child#n#1
man	man#n#1
martial artist	fighter#n#1
martial artists	fighter#n#1
men	man#n#1
mountain biker	cyclist#n#1
mountain bikers	cyclist#n#1
pants	trouser#n#1
people	person#n#1
person	person#n#1
shorts	short_pants#n#1
small boy	male_child#n#1
small girl	female_child#n#1
street	street#n#1
sunglasses	sunglasses#n#1
table	table#n#2
woman	woman#n#1
women	woman#n#1
young boy	male_child#n#1
young girl	female_child#n#1
young man	young_buck#n#1
